{
	"0": [
		[0, 0, 0, 0, 0, 0, 0, 0],
		[0, 0, 0, 0, 0, 0, 0, 0],
		[0, 0, 0, 0, 0, 0, 0, 0],
		[0, 0, 0, 2, 2, 0, 0, 0],
		[0, 0, 2, 0, 2, 0, 0, 0],
		[0, 0, 0, 0, 0, 0, 0, 0],
		[0, 0, 0, 0, 0, 0, 0, 0],
		[0, 0, 0, 0, 0, 0, 0, 0]
	],
	"1": [
		[0, 0, 0, 0, 0, 0, 0, 0],
		[0, 0, 0, 0, 0, 0, 0, 0],
		[0, 0, 8, 0, 0, 0, 0, 0],
		[0, 0, 0, 2, 2, 0, 0, 0],
		[0, 0, 0, 2, 0, 2, 0, 0],
		[0, 0, 0, 0, 0, 0, 0, 0],
		[0, 0, 0, 0, 0, 0, 0, 0],
		[0, 0, 0, 0, 0, 0, 0, 0]
	],
	"2": [
		[0, 0, 0, 0, 0, 0, 0, 0],
		[0, 0, 0, 0, 0, 0, 0, 0],
		[0, 4, 0, 0, 0, 0, 0, 0],
		[0, 0, 4, 0, 0, 0, 0, 0],
		[0, 2, 0, 0, 0, 0, 0, 0],
		[0, 0, 4, 2, 0, 0, 0, 0],
		[0, 0, 0, 0, 0, 0, 0, 0],
		[0, 0, 0, 0, 0, 0, 0, 0]
	],
	"3": [
		[0, 0, 0, 0, 0, 0, 0, 0],
		[0, 0, 0, 0, 0, 0, 0, 0],
		[0, 0, 0, 4, 0, 0, 0, 0],
		[0, 0, 0, 8, 4, 0, 0, 0],
		[0, 0, 0, 8, 8, 0, 0, 0],
		[0, 0, 0, 16, 0, 0, 0, 0],
		[0, 0, 0, 0, 16, 0, 0, 0],
		[0, 0, 0, 0, 0, 0, 0, 0]
	],
	"4": [
		[0, 0, 0, 0, 0, 0, 0, 0],
		[0, 0, 0, 8, 0, 0, 0, 0],
		[0, 2, 0, 8, 0, 2, 0, 0],
		[0, 0, 2, 4, 2, 0, 0, 0],
		[0, 0, 0, 4, 0, 0, 0, 0],
		[0, 0, 0, 0, 0, 0, 0, 0],
		[0, 0, 0, 0, 0, 0, 0, 0],
		[0, 0, 0, 0, 0, 0, 0, 0]
	],
  "5": [
	  [0, 0, 0, 0, 0, 0, 0, 0],
	  [0, 0, 2, 4, 0, 0, 0, 0],
	  [0, 0, 4, 2, 4, 0, 0, 0],
	  [0, 0, 2, 2, 2, 0, 0, 0],
	  [0, 0, 4, 2, 4, 0, 0, 0],
	  [0, 0, 0, 0, 0, 0, 0, 0],
	  [0, 0, 0, 0, 0, 0, 0, 0],
	  [0, 0, 0, 0, 0, 0, 0, 0]
  ],
  "6": [
	  [0, 0, 0, 0, 0, 0, 0, 0],
	  [0, 0, 16, 0, 0, 0, 0, 0],
	  [0, 0, 2, 8, 2, 0, 0, 0],
	  [0, 0, 0, 0, 2, 8, 2, 0],
	  [0, 0, 32, 4, 4, 0, 0, 0],
	  [0, 0, 0, 0, 0, 0, 0, 0],
	  [0, 0, 0, 0, 0, 0, 0, 0],
	  [0, 0, 0, 0, 0, 0, 0, 0]
  ],
  "7": [
	  [0, 0, 0, 0, 0, 0, 0, 0],
	  [0, 0, 0, 0, 0, 0, 0, 0],
	  [0, 0, 0, 0, 0, 0, 4, 0],
	  [16, 0, 0, 0, 0, 0, 8, 0],
	  [0, 2, 0, 0, 8, 0, 0, 0],
	  [4, 4, 0, 8, 4, 0, 0, 0],
	  [0, 8, 2, 0, 0, 0, 0, 4],
	  [0, 0, 0, 0, 0, 0, 0, 0]
  ]
}
